20 20
********************
* * *  *  *     *  *
* * *    **    * * *
* *       *        *
*   * *       * * **
*    * *           *
* **   *  *    *   *
*    *  * *  * * * *
*      **          *
**  * *            *
* * *    *     * * *
*           *      *
* * *  * **    * * *
* *    *           *
* *  **    *   *   *
*     *    * *  *  *
* **   * **    * * *
*    *  * *        *
*    *   ** *   *  *
********************
1 1 18 18
